10
10
3 0 1 9
14 12 5 5 7 13 6 12 5 7 
8 0 6 12 6 13 1 0 5 5 
8 3 9 3 9 5 6 9 4 7 
3 13 6 12 7 14 8 7 9 6 
12 5 1 0 6 8 1 5 5 3 
11 13 5 3 8 0 7 14 13 6 
13 4 6 13 3 8 4 1 7 10 
13 2 8 5 4 0 3 12 4 2 
13 2 8 6 9 0 4 2 11 10 
13 3 11 9 7 11 11 9 7 11 
