20
20
17 0 1 19
12 4 4 6 5 7 13 5 4 7 12 4 5 4 6 12 5 4 4 6 
8 0 0 2 7 13 4 5 2 12 3 11 12 2 8 2 14 10 8 1 
8 0 0 0 6 6 11 13 0 0 5 7 11 11 11 10 8 3 8 6 
9 0 1 3 4 4 4 4 4 4 6 14 13 4 4 3 10 14 9 3 
8 3 11 8 0 12 4 4 4 6 0 2 14 10 8 7 10 10 12 6 
8 5 4 0 0 8 0 0 0 2 4 4 4 4 4 4 6 1 2 11 
9 7 11 9 1 8 0 0 0 0 6 0 0 0 0 0 2 5 3 14 
12 7 13 3 12 1 1 1 1 3 2 0 0 0 0 0 2 5 4 3 
10 12 7 12 12 4 4 4 4 4 4 6 0 0 0 0 2 14 8 7 
8 1 7 8 8 0 0 0 0 0 0 0 1 1 1 0 3 10 8 7 
10 14 12 8 8 0 0 0 0 0 0 2 0 4 5 2 9 2 9 6 
10 9 1 8 8 0 0 0 0 0 0 2 11 10 12 1 4 0 7 10 
10 13 5 1 9 1 0 1 1 1 1 3 12 2 9 7 10 10 14 10 
9 4 6 12 1 3 8 7 8 1 1 1 3 10 13 5 2 11 10 11 
14 10 9 1 4 6 8 7 11 12 7 12 7 10 12 7 10 12 3 14 
9 1 5 7 9 3 8 6 12 1 5 0 6 10 8 4 2 10 14 10 
12 4 7 14 14 14 11 11 10 12 5 3 8 2 11 10 11 8 1 2 
2 10 13 0 2 8 7 14 10 11 14 13 3 10 13 1 4 1 5 2 
10 8 5 2 10 8 7 8 2 12 0 6 14 8 4 7 11 12 6 10 
11 11 13 3 9 1 5 3 9 3 11 9 3 11 11 13 5 3 9 3 
